region_id,region,0-6,7-15,16-19,20-40,41-66,67+,population
301,OSLO,55837,64036,25672,265609,207877,77749,696780
1101,EIGERSUND,1132,1719,739,3858,4898,2439,14785
1103,STAVANGER,11735,16218,6740,43688,47283,18451,144115
1106,HAUGESUND,2636,3996,1831,10319,12823,5707,37312
1108,SANDNES,7589,10110,4057,23830,25653,9206,80445
1111,SOKNDAL,244,433,152,743,1084,600,3256
1112,LUND,264,395,146,779,1051,539,3174
1114,BJERKREIM,245,376,172,704,911,383,2791
1119,HÅ,1853,2607,1020,5348,5790,2498,19116
1120,KLEPP,1793,2620,1034,5819,6212,2366,19844
1121,TIME,1723,2493,960,5474,6013,2442,19105
1122,GJESDAL,1197,1707,599,3469,3842,1249,12063
1124,SOLA,2572,3449,1340,8117,8813,3163,27454
1127,RANDABERG,959,1438,621,3095,3660,1539,11312
1130,STRAND,1161,1700,711,3506,4088,1901,13067
1133,HJELMELAND,208,317,127,584,849,493,2578
1134,SULDAL,298,468,180,859,1255,746,3806
1135,SAUDA,325,518,184,1083,1569,879,4558
1144,KVITSØY,35,50,31,100,182,109,507
1145,BOKN,54,83,54,192,308,168,859
1146,TYSVÆR,1030,1502,621,2864,3509,1651,11177
1149,KARMØY,3439,5256,2163,10966,13906,6610,42340
1151,UTSIRA,10,18,13,43,70,38,192
1160,VINDAFJORD,701,1018,457,2229,2872,1426,8703
1505,KRISTIANSUND,1496,2517,1152,6255,8243,4432,24095
1506,MOLDE,2286,3355,1582,8225,10533,5878,31859
1507,ÅLESUND,5057,7294,3239,18955,21699,10414,66658
1511,VANYLVEN,161,253,139,641,1085,801,3080
1514,SANDE,152,231,129,512,911,509,2444
1515,HERØY,624,988,470,2078,3084,1614,8858
1516,ULSTEIN,670,1003,496,2141,2968,1296,8574
1517,HAREID,434,594,242,1333,1670,867,5140
1520,ØRSTA,850,1261,542,2744,3465,1966,10828
1525,STRANDA,279,432,218,1116,1511,924,4480
1528,SYKKYLVEN,514,866,419,1785,2615,1395,7594
1531,SULA,838,1238,455,2539,2978,1360,9408
1532,GISKE,840,1083,457,2202,2687,1234,8503
1535,VESTNES,465,728,337,1583,2485,1356,6954
1539,RAUMA,493,769,339,1608,2343,1470,7022
1547,AUKRA,238,467,193,872,1105,647,3522
1554,AVERØY,368,660,297,1303,2045,1134,5807
1557,GJEMNES,196,290,154,601,865,550,2656
1560,TINGVOLL,177,298,152,603,1061,692,2983
1563,SUNNDAL,483,637,338,1639,2496,1360,6953
1566,SURNADAL,383,558,281,1383,2004,1263,5872
1573,SMØLA,126,201,93,480,740,487,2127
1576,AURE,210,334,163,747,1245,769,3468
1577,VOLDA,768,1132,578,3224,3213,1865,10780
1578,FJORD,123,279,143,503,882,569,2499
1579,HUSTADVIKA,1043,1549,714,3347,4364,2293,13310
1804,BODØ,3855,5644,2459,15645,17259,7691,52553
1806,NARVIK,1440,2155,926,5631,7328,4174,21654
1811,BINDAL,84,149,67,240,482,374,1396
1812,SØMNA,107,214,110,435,703,420,1989
1813,BRØNNØY,517,892,396,1892,2747,1359,7803
1815,VEGA,61,116,55,236,436,278,1182
1816,VEVELSTAD,30,37,22,92,171,113,465
1818,HERØY,149,184,72,429,600,358,1792
1820,ALSTAHAUG,510,737,385,1822,2527,1413,7394
1822,LEIRFJORD,218,250,87,551,752,416,2274
1824,VEFSN,878,1290,667,3299,4558,2574,13266
1825,GRANE,80,151,69,336,479,337,1452
1826,HATTFJELLDAL,56,126,63,248,445,328,1266
1827,DØNNA,66,144,74,268,504,315,1371
1828,NESNA,103,179,90,383,628,317,1700
1832,HEMNES,302,441,200,1024,1481,978,4426
1833,RANA,1726,2731,1223,6826,8871,4702,26079
1834,LURØY,123,190,73,444,621,424,1875
1835,TRÆNA,20,38,24,124,160,76,442
1836,RØDØY,80,122,80,268,397,259,1206
1837,MELØY,431,672,322,1475,2101,1242,6243
1838,GILDESKÅL,97,183,74,384,703,479,1920
1839,BEIARN,54,72,41,195,355,282,999
1840,SALTDAL,332,471,193,1022,1603,1010,4631
1841,FAUSKE,612,910,445,2368,3370,1935,9640
1845,SØRFOLD,120,172,103,385,648,481,1909
1848,STEIGEN,152,247,102,587,883,614,2585
1851,LØDINGEN,84,187,78,354,760,539,2002
1853,EVENES,57,121,63,265,458,359,1323
1856,RØST,21,42,19,109,195,102,488
1857,VÆRØY,36,77,24,161,257,143,698
1859,FLAKSTAD,64,102,63,253,445,311,1238
1860,VESTVÅGØY,881,1281,599,3011,3708,2035,11515
1865,VÅGAN,676,978,468,2536,3263,1749,9670
1866,HADSEL,553,823,355,1988,2701,1644,8064
1867,BØ,145,195,98,502,958,678,2576
1868,ØKSNES,277,420,213,1081,1565,859,4415
1870,SORTLAND,779,1167,526,2798,3461,1777,10508
1871,ANDØY,259,419,205,1039,1559,1105,4586
1874,MOSKENES,39,71,33,244,370,232,989
1875,HAMARØY,131,257,128,605,915,665,2701
3001,HALDEN,2065,3281,1548,7859,10865,5763,31381
3002,MOSS,3311,5244,2375,11967,17776,8985,49658
3003,SARPSBORG,4194,6321,2816,14844,19506,9680,57361
3004,FREDRIKSTAD,5737,8771,4058,21155,29267,14191,83179
3005,DRAMMEN,7462,11013,4925,27937,34487,16015,101839
3006,KONGSBERG,1846,3117,1255,7116,9541,4817,27692
3007,RINGERIKE,1961,3061,1389,7789,10861,5766,30827
3011,HVALER,220,431,189,774,1926,1154,4694
3012,AREMARK,72,122,69,263,520,278,1324
3013,MARKER,226,319,160,749,1308,838,3600
3014,INDRE ØSTFOLD,3276,4932,2108,11266,15876,7734,45192
3015,SKIPTVET,269,465,193,948,1337,613,3825
3016,RAKKESTAD,575,845,418,1987,2886,1510,8221
3017,RÅDE,546,798,348,1712,2745,1418,7567
3018,VÅLER (VIKEN),561,723,231,1596,1938,756,5805
3019,VESTBY,1564,2271,944,4344,6332,2832,18287
3020,NORDRE FOLLO,4870,7534,3200,14344,20960,9117,60025
3021,ÅS,1603,2314,890,6578,6413,2638,20436
3022,FROGN,922,1800,838,3231,6202,2960,15953
3023,NESODDEN,1624,2466,1001,4434,7381,2897,19803
3024,BÆRUM,10829,15531,6563,31082,44992,19197,128194
3025,ASKER,7447,11654,4996,22290,34160,14344,94891
3026,AURSKOG-HØLAND,1260,1900,857,4205,6243,3121,17586
3027,RÆLINGEN,1694,2274,865,5288,6325,2282,18728
3028,ENEBAKK,825,1451,539,2703,4013,1533,11064
3029,LØRENSKOG,3607,4662,2061,12122,14412,5873,42737
3030,LILLESTRØM,6942,10144,4358,23608,30058,11832,86942
3031,NITTEDAL,2018,3183,1312,5849,8917,3172,24451
3032,GJERDRUM,545,842,392,1660,2597,1007,7043
3033,ULLENSAKER,3361,5044,2092,11848,13341,4771,40457
3034,NES,1968,2501,1108,6025,8340,3477,23419
3035,EIDSVOLL,2095,3046,1211,7167,8809,3701,26029
3036,NANNESTAD,1258,1719,734,4211,5024,1688,14634
3037,HURDAL,196,297,111,651,1026,556,2837
3038,HOLE,528,837,294,1497,2530,1123,6809
3039,FLÅ,55,98,47,248,366,235,1049
3040,NESBYEN,169,290,141,668,1226,766,3260
3041,GOL,300,450,219,1087,1646,930,4632
3042,HEMSEDAL,195,284,108,718,883,358,2546
3043,ÅL,267,508,253,1019,1630,970,4647
3044,HOL,281,362,212,1084,1581,912,4432
3045,SIGDAL,199,355,168,688,1282,771,3463
3046,KRØDSHERAD,157,252,78,499,812,421,2219
3047,MODUM,969,1463,618,3506,4958,2651,14165
3048,ØVRE EIKER,1506,2107,939,5229,6761,3165,19707
3049,LIER,2165,3209,1326,6739,9684,3993,27116
3050,FLESBERG,202,291,122,673,906,518,2712
3051,ROLLAG,96,101,67,320,473,329,1386
3052,NORE OG UVDAL,119,221,122,522,876,552,2412
3053,JEVNAKER,485,713,332,1679,2413,1244,6866
3054,LUNNER,643,996,450,2071,3372,1527,9059
3401,KONGSVINGER,1023,1760,850,3963,6371,3882,17849
3403,HAMAR,1995,3147,1410,8148,10525,6278,31503
3405,LILLEHAMMER,1899,2805,1388,7804,9358,5230,28484
3407,GJØVIK,1929,3057,1465,8180,10232,5526,30389
3411,RINGSAKER,2398,3606,1642,8790,12204,6247,34887
3412,LØTEN,521,791,352,1894,2628,1438,7624
3413,STANGE,1620,2158,980,5192,7301,3815,21066
3414,NORD-ODAL,245,461,231,1054,1887,1159,5037
3415,SØR-ODAL,476,751,334,1880,2954,1516,7911
3416,EIDSKOG,304,501,267,1228,2361,1434,6095
3417,GRUE,190,345,197,891,1722,1197,4542
3418,ÅSNES,374,601,317,1475,2686,1770,7223
3419,VÅLER (INNLANDET),183,277,165,683,1393,886,3587
3420,ELVERUM,1487,2241,1064,5421,7185,3890,21288
3421,TRYSIL,390,587,273,1440,2359,1529,6578
3422,ÅMOT,248,390,207,1229,1397,865,4336
3423,STOR-ELVDAL,109,197,81,494,888,609,2378
3424,RENDALEN,74,159,70,278,676,483,1740
3425,ENGERDAL,61,97,65,214,476,337,1250
3426,TOLGA,120,177,74,372,522,298,1563
3427,TYNSET,326,636,292,1359,1878,1045,5536
3428,ALVDAL,193,275,124,554,818,440,2404
3429,FOLLDAL,65,145,65,273,568,401,1517
3430,OS (INNLANDET),100,154,96,411,699,409,1869
3431,DOVRE,152,199,106,547,882,625,2511
3432,LESJA,137,217,107,397,696,426,1980
3433,SKJÅK,122,185,123,447,778,528,2183
3434,LOM,137,191,112,470,794,500,2204
3435,VÅGÅ,208,382,159,779,1248,787,3563
3436,NORD-FRON,339,543,272,1248,2003,1298,5703
3437,SEL,329,518,263,1197,2027,1257,5591
3438,SØR-FRON,181,332,154,652,1101,643,3063
3439,RINGEBU,274,395,187,1030,1526,996,4408
3440,ØYER,372,486,217,1266,1764,987,5092
3441,GAUSDAL,344,591,255,1392,2187,1252,6021
3442,ØSTRE TOTEN,985,1427,682,3449,5337,2989,14869
3443,VESTRE TOTEN,825,1329,621,3361,4734,2588,13458
3446,GRAN,818,1418,685,3023,5031,2634,13609
3447,SØNDRE LAND,350,494,250,1198,2141,1145,5578
3448,NORDRE LAND,412,633,282,1440,2434,1380,6581
3449,SØR-AURDAL,152,278,132,606,1059,676,2903
3450,ETNEDAL,57,132,58,247,449,314,1257
3451,NORD-AURDAL,400,595,288,1483,2218,1376,6360
3452,VESTRE SLIDRE,114,230,101,453,795,427,2120
3453,ØYSTRE SLIDRE,211,311,148,783,1118,664,3235
3454,VANG,93,168,72,376,532,331,1572
3801,HORTEN,1777,2856,1341,6895,9561,5072,27502
3802,HOLMESTRAND,1834,2665,1143,6162,8830,4374,25008
3803,TØNSBERG,4132,6133,2591,15324,19600,9234,57014
3804,SANDEFJORD,4644,6990,3182,16221,22254,11031,64322
3805,LARVIK,3231,4937,2176,11184,16770,9182,47480
3806,PORSGRUNN,2450,3757,1762,9269,12798,6482,36518
3807,SKIEN,3946,5832,2609,13994,19012,9736,55129
3808,NOTODDEN,868,1324,605,3158,4527,2507,12989
3811,FÆRDER,1848,2938,1308,5940,9721,5198,26953
3812,SILJAN,155,264,114,532,849,430,2344
3813,BAMBLE,919,1504,686,3290,4914,2701,14014
3814,KRAGERØ,605,1014,439,2220,3756,2378,10412
3815,DRANGEDAL,244,436,217,888,1477,805,4067
3816,NOME,420,632,318,1454,2355,1307,6486
3817,MIDT-TELEMARK,728,1123,501,2989,3278,1840,10459
3818,TINN,251,548,283,1167,2097,1255,5601
3819,HJARTDAL,105,147,89,322,543,354,1560
3820,SELJORD,161,324,150,632,991,641,2899
3821,KVITESEID,132,199,114,521,928,535,2429
3822,NISSEDAL,96,174,52,277,524,306,1429
3823,FYRESDAL,57,143,65,242,466,254,1227
3824,TOKKE,105,234,99,468,805,453,2164
3825,VINJE,260,374,171,915,1291,744,3755
4201,RISØR,370,669,293,1433,2468,1524,6757
4202,GRIMSTAD,1855,2793,1267,6825,7605,3542,23887
4203,ARENDAL,3088,5086,2131,11125,15819,7807,45056
4204,KRISTIANSAND,8872,12852,5578,33651,35826,15790,112569
4205,LINDESNES,1715,2767,1188,5641,7768,3966,23045
4206,FARSUND,717,1106,462,2314,3213,1832,9644
4207,FLEKKEFJORD,651,1067,442,2141,2993,1730,9024
4211,GJERSTAD,134,251,108,543,903,490,2429
4212,VEGÅRSHEI,150,271,118,505,768,316,2128
4213,TVEDESTRAND,362,637,290,1382,2190,1203,6064
4214,FROLAND,517,737,299,1612,1967,871,6003
4215,LILLESAND,838,1420,522,2743,3800,1855,11178
4216,BIRKENES,462,733,261,1367,1663,787,5273
4217,ÅMLI,151,193,79,429,600,370,1822
4218,IVELAND,137,175,50,360,434,179,1335
4219,EVJE OG HORNNES,257,448,176,893,1184,660,3618
4220,BYGLAND,62,108,54,240,410,268,1142
4221,VALLE,63,111,56,278,414,246,1168
4222,BYKLE,56,90,41,269,348,126,930
4223,VENNESLA,1246,1823,692,4312,4820,2040,14933
4224,ÅSERAL,65,102,68,230,326,136,927
4225,LYNGDAL,932,1359,606,2715,3234,1617,10463
4226,HÆGEBOSTAD,151,196,93,429,542,277,1688
4227,KVINESDAL,442,674,307,1488,2001,1009,5921
4228,SIRDAL,124,220,95,430,582,318,1769
4601,BERGEN,21797,27996,12448,93906,89466,39910,285523
4602,KINN,1169,2054,914,4319,5840,2855,17151
4611,ETNE,316,464,213,955,1328,775,4051
4612,SVEIO,492,785,299,1478,1837,905,5796
4613,BØMLO,951,1552,682,2995,3814,1952,11946
4614,STORD,1596,2228,964,5044,6100,2924,18856
4615,FITJAR,257,390,175,759,1048,517,3146
4616,TYSNES,251,285,122,681,902,682,2923
4617,KVINNHERAD,857,1479,704,2963,4398,2631,13032
4618,ULLENSVANG,663,1134,499,2513,3807,2376,10992
4619,EIDFJORD,71,79,40,193,339,180,902
4620,ULVIK,76,108,44,223,358,251,1060
4621,VOSS,1228,1682,808,3914,5091,3058,15781
4622,KVAM,650,942,447,1902,2784,1729,8454
4623,SAMNANGER,193,268,106,574,856,505,2502
4624,BJØRNAFJORDEN,2121,3243,1297,6623,7964,3796,25044
4625,AUSTEVOLL,509,658,282,1388,1606,832,5275
4626,ØYGARDEN,3434,4880,2099,10219,12830,5196,38658
4627,ASKØY,2657,4062,1609,7779,9551,3932,29590
4628,VAKSDAL,296,425,167,967,1265,797,3917
4629,MODALEN,26,50,26,89,121,64,376
4630,OSTERØY,661,924,433,2072,2597,1389,8076
4631,ALVER,2389,3704,1524,7319,9611,4782,29329
4632,AUSTRHEIM,203,303,148,657,945,603,2859
4633,FEDJE,29,55,30,86,195,129,524
4634,MASFJORDEN,116,187,75,351,553,378,1660
4635,GULEN,150,217,122,523,771,488,2271
4636,SOLUND,43,74,38,160,282,189,786
4637,HYLLESTAD,68,102,68,257,470,327,1292
4638,HØYANGER,232,401,212,874,1451,878,4048
4639,VIK,178,281,128,535,848,639,2609
4640,SOGNDAL,1010,1257,616,3630,3539,1885,11937
4641,AURLAND,110,153,76,507,597,333,1776
4642,LÆRDAL,131,202,107,475,762,450,2127
4643,ÅRDAL,326,481,217,1211,1852,1082,5169
4644,LUSTER,426,573,267,1214,1710,995,5185
4645,ASKVOLL,203,318,153,609,987,716,2986
4646,FJALER,182,335,306,637,827,598,2885
4647,SUNNFJORD,1803,2731,1200,5918,7056,3308,22016
4648,BREMANGER,209,367,206,709,1244,858,3593
4649,STAD,726,1067,487,2236,3165,1828,9509
4650,GLOPPEN,435,651,363,1347,1881,1204,5881
4651,STRYN,526,830,395,1703,2355,1307,7116
5001,TRONDHEIM,15477,20755,9172,72364,62743,27062,207573
5006,STEINKJER,1651,2620,1148,5793,8122,4809,24143
5007,NAMSOS,1022,1675,786,3784,4986,2843,15096
5014,FRØYA,427,488,192,1605,1704,786,5202
5020,OSEN,52,84,31,177,326,255,925
5021,OPPDAL,504,734,352,1642,2353,1394,6979
5022,RENNEBU,167,234,125,476,872,579,2453
5025,RØROS,335,505,226,1292,1945,1246,5549
5026,HOLTÅLEN,112,197,78,427,678,475,1967
5027,MIDTRE GAULDAL,495,637,266,1625,2066,1153,6242
5028,MELHUS,1392,2019,883,4445,5564,2645,16948
5029,SKAUN,809,1163,384,2211,2693,1105,8365
5031,MALVIK,1273,1820,778,3678,4971,1812,14332
5032,SELBU,272,416,213,909,1410,847,4067
5033,TYDAL,43,61,36,149,277,193,759
5034,MERÅKER,155,238,111,508,872,529,2413
5035,STJØRDAL,1833,2896,1264,6114,8114,4052,24273
5036,FROSTA,168,277,121,621,887,534,2608
5037,LEVANGER,1589,2295,1014,5280,6525,3465,20168
5038,VERDAL,1026,1649,744,3799,5006,2761,14985
5041,SNÅSA,135,218,105,443,687,465,2053
5042,LIERNE,76,124,87,250,470,321,1328
5043,RØYRVIK,29,49,23,92,150,115,458
5044,NAMSSKOGAN,53,81,36,169,290,217,846
5045,GRONG,161,239,109,528,797,513,2347
5046,HØYLANDET,78,156,76,236,377,292,1215
5047,OVERHALLA,331,499,190,984,1223,636,3863
5049,FLATANGER,58,76,53,253,414,246,1100
5052,LEKA,39,56,20,103,193,152,563
5053,INDERØY,514,779,371,1533,2239,1327,6763
5054,INDRE FOSEN,639,1108,522,2104,3497,2076,9946
5055,HEIM,397,599,265,1376,1998,1305,5940
5056,HITRA,360,456,232,1394,1744,953,5139
5057,ØRLAND,796,1091,459,2615,3373,1970,10304
5058,ÅFJORD,322,352,194,943,1497,961,4269
5059,ORKLAND,1263,2032,840,4455,6169,3537,18296
5060,NÆRØYSUND,752,1031,488,2503,3126,1680,9580
5061,RINDAL,146,188,110,442,645,458,1989
5401,TROMSØ,5730,7946,3417,25517,24903,9573,77086
5402,HARSTAD,1722,2581,1135,6535,8297,4464,24734
5403,ALTA,1758,2437,1144,6204,6598,2706,20847
5404,VARDØ,94,143,75,474,733,439,1958
5405,VADSØ,347,531,285,1419,2013,1047,5642
5406,HAMMERFEST,840,1166,504,3292,3780,1747,11329
5411,KVÆFJORD,169,271,142,658,979,601,2820
5412,TJELDSUND,238,422,169,836,1508,1036,4209
5413,IBESTAD,50,101,65,247,461,396,1320
5414,GRATANGEN,64,91,69,208,411,248,1091
5415,LAVANGEN,56,128,54,189,356,234,1017
5416,BARDU,265,428,193,1185,1150,737,3958
5417,SALANGEN,104,193,126,459,743,464,2089
5418,MÅLSELV,435,655,315,1878,2120,1206,6609
5419,SØRREISA,229,360,188,868,1186,633,3464
5420,DYRØY,41,96,46,213,394,271,1061
5421,SENJA,966,1650,750,3553,4956,2849,14724
5422,BALSFJORD,332,536,232,1270,1974,1214,5558
5423,KARLSØY,109,163,70,484,784,562,2172
5424,LYNGEN,138,253,129,572,959,722,2773
5425,STORFJORD,88,172,88,397,647,439,1831
5426,KÅFJORD,112,188,85,456,702,528,2071
5427,SKJERVØY,205,276,132,780,939,560,2892
5428,NORDREISA,299,537,231,1168,1634,943,4812
5429,KVÆNANGEN,56,98,51,244,411,306,1166
5430,KAUTOKEINO,231,327,122,754,1019,467,2920
5432,LOPPA,37,50,30,186,322,235,860
5433,HASVIK,58,88,34,237,368,197,982
5434,MÅSØY,61,96,39,281,423,297,1197
5435,NORDKAPP,157,264,146,781,1135,592,3075
5436,PORSANGER,228,354,178,937,1443,781,3921
5437,KARASJOK,165,241,131,712,933,459,2641
5438,LEBESBY,70,105,63,306,470,257,1271
5439,GAMVIK,63,61,41,304,414,214,1097
5440,BERLEVÅG,47,61,42,223,341,214,928
5441,TANA,166,232,115,663,1052,600,2828
5442,NESSEBY,33,86,31,206,295,229,880
5443,BÅTSFJORD,150,197,97,649,761,346,2200
5444,SØR-VARANGER,639,967,495,2839,3499,1662,10101
